33222222222222222233
33000000000000000033
20000000000000000002
20000111111111000002
20000100000001000002
20000100000001000002
20000100000001000002
20000100000001000002
20000100000001000002
20000100000001000002
20000111111111000002
20000100000001000002
20000100000001000002
33000100000001000033
33222222222222222233
