00000000000000000000
00000000000000000000
00000000000000000000
00000000000000000000
00000000000000000000
00000000000000000000
00000000000000000000
00000111100000000000
00000100100000000000
00000111100000000000
00000000100000000000
00000000100000000000
00000111100000000000
00000000000000000000
00000000000000000000
