33222222222222222233
33000000000000000033
20000000000000000002
20000000000000000002
20000000000000000002
20000000000000000002
20000011100000000002
20000010000000000002
20000011100000000002
20000000100000000002
20000011100000000002
20000000000000000002
20000000000000000002
33000000000000000033
33222222222222222233