33222222222222222233
33000000000000000033
20000000000000000002
20000000000000000002
20000000000000000002
20000000000000000002
20000000000000000002
20000000000000000002
20000000000000000002
20000000000000000002
20000000010111000002
20000000010101000002
20000000010111000002
33000000000000000033
33222222222222222233