00000000000000000000
00000000000000000000
00000000000000000000
00000000000000000000
00000000000000000000
00000000000000000000
00000000111100000000
00000000000100000000
00000000111100000000
00000000100100000000
00000000111100000000
00000000000000000000
00000000000000000000
00000000000000000000
00000000000000000000
