33222222222222222233
33000000000000000033
20000000000000000002
20000000000000000002
20000000000000000002
20000000000000000002
20000000000000000002
20001110000000000002
20001000000000000002
20001110000000000002
20001010000000000002
20001110000000000002
20000000000000000002
33000000000000000033
33222222222222222233