00000000100000000000
00000000000000000001
00000010001000000100
00000000000000001000
00001000000010000000
00000100000000000000
00000000100000000000
00000000000000000001
00000010001000000100
00000000000000001000
00001000000010000000
00000100000000000000
00000000100000000000
00000000000000000001
00000010001000000100
